1111111111111111111
1E000000000000C0111
1P10010100100001111
1111111111111111111
1111111111111111111