1111111111111111111
1E0C00P000000000111
1111111111111111111