111111111111111111
1E000000000000C011
1P1001010010000111
111111111111111111
111111111111111111