1111111111111111111
1E0C000000000000111
1P10010100100001111
1111111111111111111
1111111111111111111