111111011
11E000111
111100111
111P00111
111111110