11111111111111111111111111111
10010000000C1100C11111C000001
10010000000C110100C0110000111
1000E1111100000111101000C0011
1P000001000011101110CC0011101
11111111111111111111111111111