111111111
11E000111
11C000111
111110111
111P00111
111111111