111111111111111111111111111111111111111111111111111
1X000000000000000000000000000000000X00C0C0CC0000001
10000000CCCCCCCCCCCCCCCCCCCCCCCCCCCCC11000010000001
1000E0000000C00000000000000000000000C01000010001001
1P0000000000000000000000000000000000001000010001001
111111111111111111111111111111111111111111111111111