111111111111111111111111111111111111111111111111111
100000000000000000000000000000000000000000000000001
1000C0000000000000000000000000000000011000010000001
100CEC000C00000000CCCCCCCCCCCCC00000001000010001001
1P00C0000000000000000000000000000000001000010001001
100000000000000000000000000000000000000000000000001
100000000000000000000000000000000000000000000000001
100000000000000000000000000000000000000000C00000001
100000000000000000000000000000000000000000000000001
100000000000000000000000000000000000000000X00000001
100000000000000000000000000000000000000000000000001
100000000000000000000000000000000000000000000000001
100000000000000000000000000000000000000000000000001
100000000000000000000000000000000000000000000000001
100000000000000000000000000000000000000000000000001
10000000000000000000000000000000000000000X000000001
100000000000000000000000000000000000000000000000001
100000000000000000000000000000000000000000000000001
1000000000000000000000000000000000000000X0000000001
10000000000000X000000000000000000000000000000000001
10000X0000000000000000000000000000000X0000000000001
100000000000000000000000000000000000000000000000001
10000000X000000000000000000000000000000000000000001
100000000000000X000000X000000000000X000000000000001
100000000000000000000000000000000000000000000000001
10000000000X00000000000000000000000X000000000000001
100000000000000000000000000000000000000000000000001
100000000000000000000000000000000000000000000000001
10000000000000000000000X000000000000000000000000001
100000000000000000000000000000000000000000000000001
100000000000000000000000000000000000000000000000001
100000000000000000000000000000000000000000000000001
100000000000000000000000000000000000000000000000001
111111111111111111111111111111111111111111111111111