111111111
11E000111
11C100111
111111111
111P00111
111111111