11111111111111111111111111111
10010000000C1100C11111C000001
10010000000C110100C0111110111
100001111100000111101000C0011
1P0000E1000011101110CC0011101
11111111111111111111111111111