11111111111111111111111111111
1001CCCCCCCC11CCC11111CCCCC01
1001CCCCCCCC110100C011CCCC111
1000E1111100000111101CCCCCC11
1P000000000000000000CCCCCCCC1
11111111111111111111111111111