1111111111111111111
1E0000000000C001111
1010010100100001111
1P10010010101011111
1111111111111111111