1111111111111111111111111111111111
1E0000000000000C00000C00000X000001
1010010100100000101001000000010101
1P100100101010100010010000X0010101
1111111111111111111111111111111111