111111111111111111111111
1P0000000000111110000111
110000000000X11100000011
1111E0000C000000C0C00111
111111111111111111111111