1111111111111111111111111111111111
100000000000000C00000C00000X000001
1010010100100000101001000000010101
1010010010101010001001000011111111
1P0000000C00C0000000000000E00X00C1
1111111111111111111111111111111111