11111111111111111111111111111111111111111111111111111111111111111111111111111111
10000000000PCE000000000000000000000000000000000000000000000000000000000000000111
1000000000000000000000000000000000000000000000000000000000000X0000000000000001X1
11111111111111111111111111111111111111111111111111111111111111111111111111111111